1111111111
1000000001
1P00000011
1110000001
1C10000111
10001100C1
1C00010001
1110000011
100C0010E1
1111111111
