11111111111111111111111111111
100100000001001100000000000E1
1C010010000100100001000000001
10000000000C00000C00000100001
1P0000100000 0000000000100001
11111111111111111111111111111
