11111111111111111111111111111
100P00000001001100000000000E1
1C0100E0000100100001000000001
10000000000C00000C00000100001
1E000010000000000000000100001
11111111111111111111111111111
