11111111111111111111111111111
10010000000100110000000000001
1C010010000100100001000000001
10000000000C00000C00000100001
1P000010000000000000000100001
11111111111111111111111111111
