1111111111111111111
1001000000010011ME1
1C01001000010010M01
100000M0000C00M00C1
1P00001000000000001
1111111111111111111
