1111111111111
10010C00000C1
1000001111001
1P0011E1000C1
10010C10000C1
1111111111111
