0111111111111
10010C00000C1
1000000111000
1P0010E0000C1
10010C00000C1
1111110111111
