1111111111111
100000C1
100000111001
1P0000E1000C1
10000C00C1
1111111111111
