11111111111111111111111111111111111111111111111111111111111111111111111111111111111111111111111111111111111111111111111111111111111111111111111111111111111111111111111111111111111111111111111111111111111111111111111111111111111111111111111111111111111111111111111111111111111111111111111111111111111111111111111111111111111111111111111111111111111111111111111111111111111111111111111111111111111111111111111111111111111111111111
100100000001001100000000000E00000000000000000000000000000000000000000000000000000000000000000000000000000011C0100100001001000010000000000000000000000000000000000000000000000000000000000000000000000000000000000000011C0100100001001000010000000000000000000000000000000000000000000000000000000000000000000000000000000000000011C010010000100100001000000000000000000000000000000000000000000000000000000000000000000000000000000000000001
1C0100100001001000010000000000000000000000000000000000000000000000000000000000000000000000000000000000000011C0100100001001000010000000000000000000000000000000000000000000000000000000000000000000000000000000000000011C0100100001001000010000000000000000000000000000000000000000000000000000000000000000000000000000000000000011C010010000100100001000000000000000000000000000000000000000000000000000000000000000000000000000000000000001
10000000000C00000C000001000000000000000000000000000000000000000000000000000000000000000000000000000000000011C0100100001001000010000000000000000000000000000000000000000000000000000000000000000000000000000000000000011C0100100001001000010000000000000000000000000000000000000000000000000000000000000000000000000000000000000011C010010000100100001000000000000000000000000000000000000000000000000000000000000000000000000000000000000001
1P0000100000000000000001000000000000000000000000000000000000000000000000000000000000000000000000000000000011C0100100001001000010000000000000000000000000000000000000000000000000000000000000000000000000000000000000011C0100100001001000010000000000000000000000000000000000000000000000000000000000000000000000000000000000000011C010010000100100001000000000000000000000000000000000000000000000000000000000000000000000000000000000000001
11111111111111111111111111111111111111111111111111111111111111111111111111111111111111111111111111111111111111111111111111111111111111111111111111111111111111111111111111111111111111111111111111111111111111111111111111111111111111111111111111111111111111111111111111111111111111111111111111111111111111111111111111111111111111111111111111111111111111111111111111111111111111111111111111111111111111111111111111111111111111111111
