1111111111111
10000C00000C1
1000000111001
1P0000E1000C1
10000C00000C1
1111111111111
