11111111111111111111111111111
10010000000100110000000000E11
1C010010000100100001000000011
10000000000C00000C00000100011
1P000010000000000000000100011
11111111111111111111111111111
