11111111111111111111111111111
100100000001001100000000000E1
1C010010000100100101000000001
11111111111111111111111111101
1P000010000000000100000100001
11111111111111111111111111111
