11111111111111111111111111111
1C0100100001001000010000000E1
10000000000C00000C00000100001
1P000010000000000000000100001
11111111111111111111111111111
11111111111111111111111111111
